NO   ./tdrsdsfds.png  
SO ./path_to_the_south_texture
WE ./path_to_the_west_texture
EA ./path_to_the_east_texture
F 220,100,0
C 25,1,01


111111
101  001
11  1
1111001
11111N1
1111111